. . . . . . H .
D . . . . . . .
* * . . . . . .
* * * . . . . .
* * * . . . . .
* . . . . . . .
. . . . . . . /
